1111111111111111111111111111111111
1E0000000000E000000000000000000001
1010010100100000101001000000010101
101XC10010101010001001000000010101
1P000X0000000000000000000000000001
1111111111111111111111111111111111